##########
#        #
#  $  +  #
#        #
##########
