           ########
           #      #
############     .#
#    #   $       .#
#    #  $  #     .#
#      $   #     .#
#    #$    ########
#    #     #
##@#########
 ###
