###########
#         #
#         #
#  . . .  #
#    $    #
#    $    #
#    $    #
#         #
#    @    #
#         #
###########
